NO  ./path_to_the_nort_texture
SO  ./path_to_the_south_texture
EA  ./path_to_the_east_texture
WE  ./path_to_the_weast_texture

C 220,142,20
F 225,45,20

1111111111111
1000000000001
1000111000001
1000001000001
1000001111001
1000000000001
1001111110001
1000000000001
1111111111111
