NO ./path_to_the_north_texture
WE ./path_to_the_west_texture
EA ./path_to_the_east_texture
SO ./path_to_the_south_texture

F 0,04,0
C 255,20, 220

        1111111111111111111111111
        110000000011000000000S001
        1011000001110000011100001
        1111111111111111111111111