NO  ./path_to_the_nort_texture
SO  ./path_to_the_south_texture
EA  ./path_to_the_east_texture
WE  ./path_to_the_weast_texture

C 220,142,20
F 220,142,21

1111111111111
1111111111111
1111111111111
1111111111111111111111111111111111111
11