NO  asset/image/1337462.xpm
WE  asset/image/Dual_Forces_of_Fire_and_Thunder.xpm
EA  asset/image/images.xpm
SO  asset/image/naruto.xpm

F 0,04,0
C 254,20,220

        1111111111111111111111111
        110000000011000000000S001
        1011000001110000011100001
        1111111111111111111111111